abacus	abacus
absorption spectroscopy	absorption spectroscopy
abstract object theory	abstract object theory
ac power	ac power
acceleration	acceleration
accelerator physics	accelerator physic
accelerometers	accelerometer
acids	acid
acoustics	acoustic
actinium	actinium
active fire protection	active fire protection
actuators	actuator
aden	aden
adjoint functors	adjoint functors
admiralty law	admiralty law
advanced micro devices	advanced micro device
aerial firefighting	aerial firefighting
aerial ramming	aerial ramming
aerodynamics	aerodynamics
aeronautics	aeronautics
aerospace	aerospace
aerospace engineering	aerospace engineering
aether theories	aether theory
afromontane	afromontane
age of discovery	age of discovery
age of sail	age of sail
agricultural aircraft	agricultural aircraft
agricultural machinery	agricultural machinery
air liquide	air liquide
air pollution	air pollution
aircraft engines	aircraft engine
aircraft maintenance	aircraft maintenance
airspeed	airspeed
alabaster	alabaster
albert einstein	albert einstein
alcoholic drinks	alcoholic drink
alexander litvinenko	alexander litvinenko
algorithmic information theory	algorithmic information theory
alloys	alloy
alpha centauri	alpha centauri
aluminium	aluminium
aluminium alloys	aluminium alloy
amalgam comics	amalgam comic
amateur rocketry	amateur rocketry
amazon biome	amazon biome
amber	amber
ambisonics	ambisonics
american geophysical union	american geophysical union
americium	americium
amun	amun
anaerobic digestion	anaerobic digestion
analog circuits	analog circuit
andaman sea	andaman sea
angle	angle
animal locomotion	animal locomotion
animal migration	animal migration
anoxic waters	anoxic water
anthocyanins	anthocyanins
anthropic principle	anthropic principle
antigens	antigen
antimatter	antimatter
antimicrobial peptides	antimicrobial peptide
antimony	antimony
antonie van leeuwenhoek	antonie van leeuwenhoek
aperture synthesis	aperture synthesis
aquatic locomotion	aquatic locomotion
aquatic therapy	aquatic therapy
arabian sea	arabian sea
arboreal locomotion	arboreal locomotion
arc welding	arc welding
archimedes	archimedes
architectural lighting design	architectural lighting design
arctic ocean	arctic ocean
arduino	arduino
argon	argon
argonne national laboratory	argonne national laboratory
arithmetic dynamics	arithmetic dynamic
arm holdings	arm holding
arrowverse	arrowverse
arsenic	arsenic
arson	arson
artificial intelligence	artificial intelligence
artillery	artillery
asbestos	asbestos
asphalt	asphalt
astatine	astatine
asteroseismology	asteroseismology
astrodynamics	astrodynamics
astronautics	astronautics
astronomical spectroscopy	astronomical spectroscopy
astroparticle physics	astroparticle physic
astrophotography	astrophotography
astrophysics	astrophysics
asymmetric information	asymmetric information
asymmetrical aircraft	asymmetrical aircraft
asymmetry	asymmetry
at attachment	at attachment
ati technologies	ati technology
atlantic ocean	atlantic ocean
atmosphere	atmosphere
atmosphere of earth	atmosphere of earth
atmospheric chemistry	atmospheric chemistry
atmospheric circulation	atmospheric circulation
atmospheric dispersion modeling	atmospheric dispersion modeling
atmospheric electricity	atmospheric electricity
atmospheric entry	atmospheric entry
atmospheric ghost lights	atmospheric ghost light
atmospheric sciences	atmospheric science
atmospheric sounding	atmospheric sounding
atmospheric thermodynamics	atmospheric thermodynamics
atolls	atoll
atomic physics	atomic physic
atomic tourism	atomic tourism
atomism	atomism
atoms	atom
audio electronics	audio electronics
audio engineering	audio engineering
audio mixing	audio mixing
austin powers	austin power
austronesian languages	austronesian language
automatic test equipment	automatic test equipment
automation	automation
automotive electronics	automotive electronics
automotive engineering	automotive engineering
avionics	avionics
baal	baal
backward compatibility	backward compatibility
bacteriology	bacteriology
baffin bay	baffin bay
baikonur cosmodrome	baikonur cosmodrome
bakelite	bakelite
ballistics	ballistics
ballooning	ballooning
baltic amber	baltic amber
baltic sea	baltic sea
bamboo network	bamboo network
barium	barium
baryons	baryon
bats	bat
beam robotics	beam robotics
beaufort sea	beaufort sea
berkelium	berkelium
beryllium	beryllium
biblical magi	biblical magi
bicycle lighting	bicycle lighting
bifurcation theory	bifurcation theory
big bang	big bang
bimetal	bimetal
binoculars	binoculars
biogeochemical cycle	biogeochemical cycle
biogeochemistry	biogeochemistry
biogeography	biogeography
bioluminescence	bioluminescence
biomass	biomass
biomechanics	biomechanics
biomes	biome
biomolecules	biomolecules
biophysics	biophysics
biorobotics	biorobotics
bios	bios
bird flight	bird flight
bird migration	bird migration
bismuth	bismuth
black holes	black hole
black sea	black sea
blindness	blindness
blood	blood
blowgun	blowgun
bluetooth	bluetooth
bodies of water	body of water
body fluids	body fluid
body water	body water
bohrium	bohrium
boron	boron
bosons	boson
breast imaging	breast imaging
british computer society	british computer society
broadcast engineering	broadcast engineering
broadcasting	broadcasting
broadcom	broadcom
bromine	bromine
building automation	building automation
building insulation materials	building insulation material
bulk material handling	bulk material handling
buoyancy	buoyancy
burns	burn
cable radio	cable radio
cable television	cable television
cadmium	cadmium
caesium	caesium
calcium	calcium
calcium channel blockers	calcium channel blocker
calculus of variations	calculus of variation
californium	californium
calorimetry	calorimetry
campanian volcanic arc	campanian volcanic arc
can bus	can bus
candelabra	candelabra
candles	candle
canis major overdensity	canis major overdensity
canonical hours	canonical hour
capacitance	capacitance
capacitors	capacitor
carbohydrates	carbohydrate
carbon	carbon
carbon dioxide	carbon dioxide
carbon monoxide	carbon monoxide
carbon nanotubes	carbon nanotube
cardiac electrophysiology	cardiac electrophysiology
cardiac imaging	cardiac imaging
caribbean	caribbean
caribbean sea	caribbean sea
carina nebula	carina nebula
carl zeiss ag	carl zeiss ag
cascade volcanoes	cascade volcano
cashless society	cashless society
cashmere	cashmere
catalysis	catalysis
catalyst support	catalyst support
cathode ray tube	cathode ray tube
cations	cation
celestial coordinate system	celestial coordinate system
celestial mechanics	celestial mechanic
cellular automata	cellular automaton
center of population	center of population
central processing unit	central processing unit
centralized computing	centralized computing
ceramic materials	ceramic material
cerdanya	cerdanya
cerium	cerium
cern	cern
cetology	cetology
chaos	chaos
chaos gods	chaos god
chaos theory	chaos theory
character encoding	character encoding
charcoal	charcoal
charlie jade	charlie jade
chemical accident	chemical accident
chemical compounds	chemical compound
chemical elements	chemical element
chemical kinetics	chemical kinetics
chemical oceanography	chemical oceanography
chemical physics	chemical physic
chemical thermodynamics	chemical thermodynamics
chemical vapor deposition	chemical vapor deposition
chemiluminescence	chemiluminescence
chernobyl disaster	chernobyl disaster
chernobyl exclusion zone	chernobyl exclusion zone
china meteorological administration	china meteorological administration
chirality	chirality
chloride	chloride
chlorine	chlorine
chlorofluorocarbons	chlorofluorocarbon
chromism	chromism
chromium	chromium
chronology	chronology
chukchi sea	chukchi sea
classes of computers	class of computer
classical mechanics	classical mechanic
cleaning	cleaning
climate change	climate change
climatology	climatology
clock signal	clock signal
cloud gaming	cloud gaming
cloud robotics	cloud robotics
clouds	cloud
cluster chemistry	cluster chemistry
coal	coal
coal mining	coal mining
coastal geography	coastal geography
cobalt	cobalt
code lyoko	code lyoko
coding theory	coding theory
coffee	coffee
cogeneration	cogeneration
cold	cold
cold fusion	cold fusion
cold war	cold war
collision	collision
colloids	colloid
color	color
color filter array	color filter array
color space	color space
color vision	color vision
coma cluster	coma cluster
combinatorial chemistry	combinatorial chemistry
commercial diving	commercial diving
communist nostalgia	communist nostalgia
compact disc	compact disc
complex dynamics	complex dynamic
computational anatomy	computational anatomy
computational electromagnetics	computational electromagnetics
computational fluid dynamics	computational fluid dynamic
computational geometry	computational geometry
computational particle physics	computational particle physic
computational physics	computational physic
computational science	computational science
computer architecture	computer architecture
computer data storage	computer data storage
computer engineering	computer engineering
computer graphics	computer graphic
computer hardware	computer hardware
computer memory	computer memory
computer networking	computer networking
computer networks	computer network
computer programming	computer programming
computer science	computer science
computer security	computer security
computer systems	computer system
computer vision	computer vision
computers	computer
computing	computing
concurrency control	concurrency control
condensed matter	condensed matter
condensed matter physics	condensed matter physic
conformal field theory	conformal field theory
conservatism	conservatism
consumer electronics	consumer electronics
contact geometry	contact geometry
continuity of government	continuity of government
continuum mechanics	continuum mechanic
control engineering	control engineering
convection	convection
convex analysis	convex analysis
convex hull algorithms	convex hull algorithm
convex optimization	convex optimization
copernican revolution	copernican revolution
copernicium	copernicium
copper	copper
coptic calendar	coptic calendar
coral reefs	coral reef
cordite	cordite
corrosion	corrosion
cosina	cosina
cosmic background radiation	cosmic background radiation
cosmic dust	cosmic dust
cosmic rays	cosmic ray
cosmogony	cosmogony
cosmopolitan species	cosmopolitan specie
cotton gin	cotton gin
coventry transport museum	coventry transport museum
crab nebula	crab nebula
cremation	cremation
critical phenomena	critical phenomenon
cryobiology	cryobiology
cryogenics	cryogenics
cryonics	cryonics
cryopreservation	cryopreservation
cryotherapy	cryotherapy
cryptography	cryptography
crystal engineering	crystal engineering
crystal skull	crystal skull
crystallography	crystallography
crystals	crystal
cultural history	cultural history
curium	curium
cystic fibrosis	cystic fibrosis
cytopathology	cytopathology
daikin	daikin
dark matter	dark matter
darkness	darkness
darmstadtium	darmstadtium
data compression	data compression
data differencing	data differencing
data synchronization	data synchronization
data transmission	data transmission
database theory	database theory
davis strait	davis strait
dawn	dawn
day	day
days	day
death	death
deccan plateau	deccan plateau
defcon	defcon
delta works	delta work
demand response	demand response
demodulation	demodulation
density functional theory	density functional theory
depleted uranium	depleted uranium
deserts	desert
desiccation	desiccation
destiny	destiny
detection theory	detection theory
diatoms	diatom
diesel	diesel
dieselpunk	dieselpunk
differential geometry	differential geometry
differential topology	differential topology
diffraction	diffraction
diffusion	diffusion
digital audio	digital audio
digital cameras	digital camera
digital circuits	digital circuit
digital electronics	digital electronics
digital imaging	digital imaging
digital labor	digital labor
digital photography	digital photography
digital radio	digital radio
digital revolution	digital revolution
digital signal processing	digital signal processing
digital technology	digital technology
digital television	digital television
dirac equation	dirac equation
discworld	discworld
dishwashing	dishwashing
distributed generation	distributed generation
district cooling	district cooling
district heating	district heating
divination	divination
dna	dna
dna nanotechnology	dna nanotechnology
doctor who	doctor who
domain decomposition methods	domain decomposition method
dominican amber	dominican amber
drag	drag
drakengard	drakengard
drink industry	drink industry
drinking water	drinking water
drivetrain	drivetrain
droughts	drought
dry cleaning	dry cleaning
drying	drying
dubnium	dubnium
dust	dust
dust bowl	dust bowl
dvd	dvd
dynamical systems	dynamical system
dysprosium	dysprosium
earth oven	earth oven
earthquake engineering	earthquake engineering
earthquakes	earthquake
earthworks	earthwork
ecological niche	ecological niche
ecological succession	ecological succession
ecology	ecology
economic planning	economic planning
ecosystems	ecosystem
ecozones of canada	ecozones of canada
einstein family	einstein family
einsteinium	einsteinium
el bierzo	el bierzo
electric aircraft	electric aircraft
electric cars	electric car
electric charge	electric charge
electric current	electric current
electric drag racing	electric drag racing
electric fish	electric fish
electric heating	electric heating
electric power	electric power
electric power conversion	electric power conversion
electric power distribution	electric power distribution
electric power generation	electric power generation
electric power quality	electric power quality
electric power transmission	electric power transmission
electric vehicles	electric vehicle
electrical breakdown	electrical breakdown
electrical engineering	electrical engineering
electrical engineers	electrical engineer
electrical equipment	electrical equipment
electrical grid	electrical grid
electrical phenomena	electrical phenomenon
electrical wiring	electrical wiring
electricity	electricity
electrification	electrification
electroanalytical methods	electroanalytical method
electrochemical engineering	electrochemical engineering
electrochemistry	electrochemistry
electrodes	electrode
electrodynamics	electrodynamics
electrolysis	electrolysis
electrolytes	electrolyte
electromagnetic compatibility	electromagnetic compatibility
electromagnetic radiation	electromagnetic radiation
electromagnetic spectrum	electromagnetic spectrum
electromagnetism	electromagnetism
electron	electron
electron beam	electron beam
electron microscopy	electron microscopy
electron paramagnetic resonance	electron paramagnetic resonance
electronic design automation	electronic design automation
electronic engineering	electronic engineering
electronic filter topology	electronic filter topology
electronic test equipment	electronic test equipment
electronic warfare	electronic warfare
electronic waste	electronic waste
electronics	electronics
electronics industry	electronics industry
electrophoresis	electrophoresis
electrophysiology	electrophysiology
electrostatics	electrostatics
electrotherapy	electrotherapy
electroweak theory	electroweak theory
elementary particles	elementary particle
elements of music	element of music
elliptic functions	elliptic function
embedded systems	embedded system
emergence	emergence
emergent gameplay	emergent gameplay
emerging technologies	emerging technology
emission spectroscopy	emission spectroscopy
endemism	endemism
endemism in birds	endemism in bird
endoplasmic reticulum	endoplasmic reticulum
energetics	energetics
energoatom	energoatom
energy transfer	energy transfer
engineering mechanics	engineering mechanic
engines	engine
enigma machine	enigma machine
enrico fermi	enrico fermi
enthalpy	enthalpy
entropy	entropy
environmental chemistry	environmental chemistry
environmental testing	environmental testing
enzyme kinetics	enzyme kinetics
enzymes	enzyme
equilibrium chemistry	equilibrium chemistry
erbium	erbium
ergodic theory	ergodic theory
ernest rutherford	ernest rutherford
eschatology	eschatology
estuaries	estuary
etymology	etymology
eurasian steppe	eurasian steppe
europium	europium
evening	evening
evolution	evolution
experimental physics	experimental physic
exploration of mars	exploration of mar
explosives	explosive
extinction	extinction
extragalactic astronomy	extragalactic astronomy
extropianism	extropianism
falling	falling
family planning	family planning
fatty acids	fatty acid
fault tolerance	fault tolerance
feces	feces
fermi paradox	fermi paradox
fermilab	fermilab
fermions	fermion
fermium	fermium
fiber optics	fiber optic
fiberglass	fiberglass
film	film
final destination	final destination
finite element method	finite element method
fire	fire
fire investigation	fire investigation
fire prevention	fire prevention
fire protection	fire protection
firearm maintenance	firearm maintenance
firearms	firearm
firefighting	firefighting
firelighting	firelighting
firewood	firewood
fireworks	firework
firmware	firmware
fisheries	fishery
fisheries law	fishery law
fisheries science	fishery science
fishing	fishing
fishing industry	fishing industry
fission products	fission product
flags of oceania	flag of oceania
flamethrowers	flamethrower
flatulence	flatulence
flerovium	flerovium
flexible electronics	flexible electronics
flight	flight
flood	flood
flow visualization	flow visualization
fluid dynamics	fluid dynamic
fluid mechanics	fluid mechanic
fluid power	fluid power
fluid statics	fluid static
fluorescence	fluorescence
fluorine	fluorine
fog	fog
folk culture	folk culture
force	force
forecasting	forecasting
forests	forest
formal methods	formal method
former constellations	former constellation
forming processes	forming process
formula e	formula e
fornax cluster	fornax cluster
fossil fuels	fossil fuel
fouling	fouling
four thirds system	four third system
fractals	fractal
fracture mechanics	fracture mechanic
francium	francium
fredholm theory	fredholm theory
free radicals	free radical
freescale semiconductor	freescale semiconductor
fresh water	fresh water
friction	friction
friction stir welding	friction stir welding
frisian islands	frisian island
fuel cells	fuel cell
fuel gas	fuel gas
fullerenes	fullerene
functional calculus	functional calculus
fur	fur
fusion power	fusion power
fusion reactors	fusion reactor
future	future
future history	future history
futurology	futurology
fynbos	fynbos
gadolinium	gadolinium
galaxies	galaxy
galaxies in fiction	galaxy in fiction
galilean moons	galilean moon
galileo affair	galileo affair
galileo galilei	galileo galilei
gallium	gallium
gamma rays	gamma ray
garde manger	garde manger
gas chromatography	gas chromatography
gas laws	gas law
gas separation	gas separation
gaseous signaling molecules	gaseous signaling molecule
gears	gear
gelatin	gelatin
gemstones	gemstone
genealogy	genealogy
general relativity	general relativity
geochronology	geochronology
geodesy	geodesy
geodynamics	geodynamics
geomagnetic reversal	geomagnetic reversal
geometric flow	geometric flow
geometrical optics	geometrical optic
geometry processing	geometry processing
geomicrobiology	geomicrobiology
geophysical survey	geophysical survey
geophysics	geophysics
geosocial networking	geosocial networking
geotechnical engineering	geotechnical engineering
germanium	germanium
gilding	gilding
girih	girih
gis file formats	gi file format
glaciers	glacier
glass	glass
glass art	glass art
glass production	glass production
gliding	gliding
global positioning system	global positioning system
global warming	global warming
globalfoundries	globalfoundries
glonass	glonass
gluons	gluon
gold	gold
google earth	google earth
gps navigation software	gps navigation software
grand unified theory	grand unified theory
graphics hardware	graphic hardware
gravimetry	gravimetry
gravitational lensing	gravitational lensing
gravitational waves	gravitational wave
gravity	gravity
great attractor	great attractor
great australian bight	great australian bight
greater yellowstone ecosystem	greater yellowstone ecosystem
green chemistry	green chemistry
green spain	green spain
greenhouse gas emissions	greenhouse gas emission
greenhouse gases	greenhouse gas
greenpeace	greenpeace
gregorian calendar	gregorian calendar
grenades	grenade
ground freezing	ground freezing
guiana space centre	guiana space centre
hafnium	hafnium
hall effect	hall effect
hamiltonian mechanics	hamiltonian mechanic
handedness	handedness
hang gliding	hang gliding
hardware acceleration	hardware acceleration
hardware virtualization	hardware virtualization
harpies	harpy
harry potter	harry potter
hassium	hassium
healing	healing
heart valves	heart valve
heat conduction	heat conduction
heat exchangers	heat exchanger
heat transfer	heat transfer
heating	heating
heavy equipment	heavy equipment
hebrew calendar	hebrew calendar
helium	helium
herding	herding
heterogeneous computing	heterogeneous computing
hibakusha	hibakusha
hidden variable theory	hidden variable theory
high dynamic range	high dynamic range
highlands of iceland	highland of iceland
hilbert space	hilbert space
hindu calendar	hindu calendar
histochemistry	histochemistry
histology	histology
histopathology	histopathology
historic preservation	historic preservation
historical geography	historical geography
historical reenactment	historical reenactment
historicity	historicity
historiography	historiography
history	history
history by period	history by period
history of firefighting	history of firefighting
history of fishing	history of fishing
history of glass	history of glass
history of navigation	history of navigation
history of photography	history of photography
history of software	history of software
history of spaceflight	history of spaceflight
history of thermodynamics	history of thermodynamics
hitachi	hitachi
hodge theory	hodge theory
holarctic	holarctic
holidays	holiday
holism	holism
holmium	holmium
holographic data storage	holographic data storage
holography	holography
holography in fiction	holography in fiction
holonomic brain theory	holonomic brain theory
home appliances	home appliance
home automation	home automation
home inspection	home inspection
home video	home video
homogeneous catalysis	homogeneous catalysis
horizontal coordinate system	horizontal coordinate system
horsehead nebula	horsehead nebula
household hardware	household hardware
hudson bay	hudson bay
human overpopulation	human overpopulation
human population planning	human population planning
human power	human power
human reliability	human reliability
human spaceflight	human spaceflight
human voice	human voice
hydraulic engineering	hydraulic engineering
hydraulic machinery	hydraulic machinery
hydraulics	hydraulics
hydrodynamics	hydrodynamics
hydroelectricity	hydroelectricity
hydrogen	hydrogen
hydrogen infrastructure	hydrogen infrastructure
hydrogen storage	hydrogen storage
hydrogen technologies	hydrogen technology
hydrology	hydrology
hydropower	hydropower
hydrostatics	hydrostatics
hymen	hymen
hypatia	hypatia
hyperbolic geometry	hyperbolic geometry
hyperloop	hyperloop
hypersensitivity pneumonitis	hypersensitivity pneumonitis
hysteresis	hysteresis
ice	ice
ice trade	ice trade
ideal gas	ideal gas
image compression	image compression
image processing	image processing
image segmentation	image segmentation
image sensors	image sensor
image stabilization	image stabilization
imaging	imaging
immunohistochemistry	immunohistochemistry
impact assessment	impact assessment
implementation	implementation
incandescent light bulbs	incandescent light bulb
incheon airport maglev	incheon airport maglev
incident management	incident management
incineration	incineration
india meteorological department	india meteorological department
indian ocean	indian ocean
indium	indium
indomalaya ecozone	indomalaya ecozone
indoor positioning system	indoor positioning system
induction heating	induction heating
infectious diseases	infectious disease
information geometry	information geometry
information technology	information technology
information theory	information theory
infrared	infrared
infrared spectroscopy	infrared spectroscopy
integrated circuits	integrated circuit
integration platform	integration platform
intel	intel
intelligence	intelligence
intention	intention
interaction	interaction
interactive television	interactive television
interference	interference
interferometry	interferometry
intergalactic travel	intergalactic travel
internal combustion engine	internal combustion engine
international electrotechnical commission	international electrotechnical commission
international maritime organization	international maritime organization
international seabed authority	international seabed authority
international waters	international water
international whaling commission	international whaling commission
internet access	internet access
internet culture	internet culture
internet television	internet television
interoperability	interoperability
interpolation	interpolation
interstellar communication	interstellar communication
interstellar travel	interstellar travel
interventional radiology	interventional radiology
interworld	interworld
introduced species	introduced specie
invariant theory	invariant theory
invasive species	invasive specie
invisibility	invisibility
iodine	iodine
ion channels	ion channel
ionization	ionization
ionizing radiation	ionizing radiation
ionosphere	ionosphere
ions	ion
iridium	iridium
iron	iron
iron age	iron age
ironing	ironing
ironmongery	ironmongery
isaac newton	isaac newton
island games	island game
islands	island
isotope separation	isotope separation
isotopes	isotope
isotopes of actinium	isotope of actinium
isotopes of aluminium	isotope of aluminium
isotopes of americium	isotope of americium
isotopes of antimony	isotope of antimony
isotopes of argon	isotope of argon
isotopes of arsenic	isotope of arsenic
isotopes of astatine	isotope of astatine
isotopes of barium	isotope of barium
isotopes of beryllium	isotope of beryllium
isotopes of bismuth	isotope of bismuth
isotopes of boron	isotope of boron
isotopes of bromine	isotope of bromine
isotopes of cadmium	isotope of cadmium
isotopes of caesium	isotope of caesium
isotopes of calcium	isotope of calcium
isotopes of californium	isotope of californium
isotopes of carbon	isotope of carbon
isotopes of cerium	isotope of cerium
isotopes of chlorine	isotope of chlorine
isotopes of chromium	isotope of chromium
isotopes of cobalt	isotope of cobalt
isotopes of copper	isotope of copper
isotopes of curium	isotope of curium
isotopes of europium	isotope of europium
isotopes of fluorine	isotope of fluorine
isotopes of francium	isotope of francium
isotopes of gadolinium	isotope of gadolinium
isotopes of gallium	isotope of gallium
isotopes of germanium	isotope of germanium
isotopes of gold	isotope of gold
isotopes of hafnium	isotope of hafnium
isotopes of helium	isotope of helium
isotopes of hydrogen	isotope of hydrogen
isotopes of indium	isotope of indium
isotopes of iodine	isotope of iodine
isotopes of iridium	isotope of iridium
isotopes of iron	isotope of iron
isotopes of krypton	isotope of krypton
isotopes of lanthanum	isotope of lanthanum
isotopes of lead	isotope of lead
isotopes of lithium	isotope of lithium
isotopes of lutetium	isotope of lutetium
isotopes of magnesium	isotope of magnesium
isotopes of manganese	isotope of manganese
isotopes of mercury	isotope of mercury
isotopes of molybdenum	isotope of molybdenum
isotopes of neodymium	isotope of neodymium
isotopes of neon	isotope of neon
isotopes of neptunium	isotope of neptunium
isotopes of nickel	isotope of nickel
isotopes of niobium	isotope of niobium
isotopes of nitrogen	isotope of nitrogen
isotopes of oganesson	isotope of oganesson
isotopes of osmium	isotope of osmium
isotopes of oxygen	isotope of oxygen
isotopes of palladium	isotope of palladium
isotopes of phosphorus	isotope of phosphorus
isotopes of platinum	isotope of platinum
isotopes of plutonium	isotope of plutonium
isotopes of polonium	isotope of polonium
isotopes of potassium	isotope of potassium
isotopes of protactinium	isotope of protactinium
isotopes of radium	isotope of radium
isotopes of radon	isotope of radon
isotopes of rhenium	isotope of rhenium
isotopes of rubidium	isotope of rubidium
isotopes of ruthenium	isotope of ruthenium
isotopes of samarium	isotope of samarium
isotopes of scandium	isotope of scandium
isotopes of selenium	isotope of selenium
isotopes of silicon	isotope of silicon
isotopes of silver	isotope of silver
isotopes of sodium	isotope of sodium
isotopes of strontium	isotope of strontium
isotopes of sulfur	isotope of sulfur
isotopes of tantalum	isotope of tantalum
isotopes of technetium	isotope of technetium
isotopes of tellurium	isotope of tellurium
isotopes of thallium	isotope of thallium
isotopes of thorium	isotope of thorium
isotopes of tin	isotope of tin
isotopes of titanium	isotope of titanium
isotopes of tungsten	isotope of tungsten
isotopes of uranium	isotope of uranium
isotopes of vanadium	isotope of vanadium
isotopes of xenon	isotope of xenon
isotopes of ytterbium	isotope of ytterbium
isotopes of yttrium	isotope of yttrium
isotopes of zinc	isotope of zinc
isotopes of zirconium	isotope of zirconium
iter	iter
japan meteorological agency	japan meteorological agency
johannes kepler	johannes kepler
johnson controls	johnson control
josephson effect	josephson effect
julian calendar	julian calendar
kara sea	kara sea
kinematics	kinematics
kinetics	kinetics
kingdom hearts	kingdom heart
kitchenware	kitchenware
knot theory	knot theory
knowledge sharing	knowledge sharing
konstantin tsiolkovsky	konstantin tsiolkovsky
krypton	krypton
labrador sea	labrador sea
lagrangian mechanics	lagrangian mechanic
landsat program	landsat program
language of flowers	language of flower
languages of oceania	language of oceania
laniakea supercluster	laniakea supercluster
lanthanum	lanthanum
large hadron collider	large hadron collider
laser applications	laser application
laser medicine	laser medicine
laser science	laser science
laserdisc	laserdisc
lasers	laser
lasik	lasik
last glacial maximum	last glacial maximum
last glacial period	last glacial period
laundry	laundry
lawrencium	lawrencium
laws of robotics	law of robotics
laws of thermodynamics	law of thermodynamics
lazarev sea	lazarev sea
lead	lead
legacies	legacy
leptons	lepton
leviathan	leviathan
levitation	levitation
lg electronics	lg electronics
life extension	life extension
lifting equipment	lifting equipment
light	light
light art	light art
light pollution	light pollution
light therapy	light therapy
lighting	lighting
lightning	lightning
linde plc	linde plc
linear motion	linear motion
linkedin	linkedin
lipids	lipid
liquefied natural gas	liquefied natural gas
liquid helium	liquid helium
lists of drinks	list of drink
lists of earthquakes	list of earthquake
lists of ecoregions	list of ecoregions
lists of galaxies	list of galaxy
lists of islands	list of island
lists of nebulae	list of nebula
lists of rockets	list of rocket
lithium	lithium
lithography	lithography
lithosphere	lithosphere
livermorium	livermorium
local bubble	local bubble
local group	local group
local interstellar cloud	local interstellar cloud
local loop	local loop
local sheet	local sheet
long now foundation	long now foundation
loop quantum gravity	loop quantum gravity
lubricants	lubricant
lubrication	lubrication
luminescence	luminescence
lutetium	lutetium
machine guns	machine gun
machine tools	machine tool
machine vision	machine vision
machinery	machinery
machines	machine
magnesium	magnesium
magnetic levitation	magnetic levitation
magnetic resonance imaging	magnetic resonance imaging
magnetism	magnetism
magnetohydrodynamics	magnetohydrodynamics
magnetoreception	magnetoreception
magnetoresistance	magnetoresistance
magnetostatics	magnetostatics
maintenance	maintenance
malesia	malesia
managed retreat	managed retreat
manganese	manganese
mangroves	mangrove
manifolds	manifold
map projections	map projection
marine art	marine art
marine biology	marine biology
marine conservation	marine conservation
marine electronics	marine electronics
marine energy	marine energy
marine engineering	marine engineering
marine fungi	marine fungi
marine geology	marine geology
marine salvage	marine salvage
maritime archaeology	maritime archaeology
maritime history	maritime history
maritime transport	maritime transport
materials science	material science
mathematical morphology	mathematical morphology
mathematical optimization	mathematical optimization
mathematical physics	mathematical physic
meade instruments	meade instrument
means	mean
mechanical engineering	mechanical engineering
mechanics	mechanic
mechanism design	mechanism design
mediatek	mediatek
medical imaging	medical imaging
medical physics	medical physic
medical ultrasonography	medical ultrasonography
mediterranean	mediterranean
mediterranean sea	mediterranean sea
megami tensei	megami tensei
megastructures	megastructures
megatsunami	megatsunami
meitnerium	meitnerium
memorabilia	memorabilia
memory	memory
mendelevium	mendelevium
merchant navy	merchant navy
mesh generation	mesh generation
mesh networking	mesh networking
mesoamerica	mesoamerica
mesoporous material	mesoporous material
mesoscale meteorology	mesoscale meteorology
mesoscopic physics	mesoscopic physic
met office	met office
metal theft	metal theft
metallurgy	metallurgy
metals	metal
metalworking	metalworking
metamaterials	metamaterials
meteorology	meteorology
methane	methane
microbiology	microbiology
microblogging	microblogging
microfluidics	microfluidics
microorganisms	microorganism
microprocessors	microprocessor
microscale meteorology	microscale meteorology
microscopy	microscopy
microtechnology	microtechnology
microwave chemistry	microwave chemistry
microwave transmission	microwave transmission
military communications	military communication
military computers	military computer
military intelligence	military intelligence
milk	milk
milos	milo
mime	mime
minerals	mineral
mining	mining
minkowski spacetime	minkowski spacetime
mips technologies	mips technology
missiles	missile
mnemonics	mnemonic
mobile phones	mobile phone
mobile technology	mobile technology
mobile television	mobile television
modern physics	modern physic
molecular biophysics	molecular biophysics
molecular dynamics	molecular dynamic
molecular electronics	molecular electronics
molecular geometry	molecular geometry
molecular modelling	molecular modelling
molecular physics	molecular physic
molecular vibration	molecular vibration
molecules	molecule
molybdenum	molybdenum
monomers	monomer
morning	morning
morse code	morse code
morse theory	morse theory
moscovium	moscovium
motherboard	motherboard
motion control	motion control
mpeg	mpeg
msx	msx
multiphase flow	multiphase flow
multitrack recording	multitrack recording
multiverse	multiverse
museo galileo	museo galileo
music	music
music and politics	music and politics
music education	music education
music history	music history
music in space	music in space
music industry	music industry
music production	music production
music psychology	music psychology
music technology	music technology
music theory	music theory
music visualization	music visualization
musical composition	musical composition
musical instruments	musical instrument
musical terminology	musical terminology
musicology	musicology
nanoelectronics	nanoelectronics
nanomaterials	nanomaterials
nanomedicine	nanomedicine
nanoparticles	nanoparticles
nanotechnology	nanotechnology
nanotechnology in fiction	nanotechnology in fiction
nanowire	nanowire
national weather service	national weather service
natural gas	natural gas
nautical fiction	nautical fiction
naval warfare	naval warfare
nearctic ecozone	nearctic ecozone
nebulae	nebula
nebulae in fiction	nebula in fiction
neodymium	neodymium
neon	neon
neon lighting	neon lighting
neotropic ecozone	neotropic ecozone
neptunium	neptunium
network architecture	network architecture
network performance	network performance
neuroimaging	neuroimaging
neutrino astronomy	neutrino astronomy
neutrinos	neutrino
neutron	neutron
neutron scattering	neutron scattering
neutron stars	neutron star
nickel	nickel
nicolaus copernicus	nicolaus copernicus
night	night
nihonium	nihonium
niobium	niobium
nitrogen	nitrogen
nitrogen cycle	nitrogen cycle
nobelium	nobelium
noble gases	noble gas
noise	noise
noise pollution	noise pollution
noise reduction	noise reduction
nondestructive testing	nondestructive testing
nonimaging optics	nonimaging optic
nonlinear optics	nonlinear optic
norma cluster	norma cluster
norwegian meteorological institute	norwegian meteorological institute
nostalgia	nostalgia
nostradamus	nostradamus
nuclear artillery	nuclear artillery
nuclear chemistry	nuclear chemistry
nuclear energy	nuclear energy
nuclear fallout	nuclear fallout
nuclear fusion	nuclear fusion
nuclear magnetic resonance	nuclear magnetic resonance
nuclear medicine	nuclear medicine
nuclear physics	nuclear physic
nuclear power	nuclear power
nuclear proliferation	nuclear proliferation
nuclear propulsion	nuclear propulsion
nuclear reactors	nuclear reactor
nuclear regulatory commission	nuclear regulatory commission
nuclear reprocessing	nuclear reprocessing
nuclear strategy	nuclear strategy
nuclear technology	nuclear technology
nuclear terrorism	nuclear terrorism
nuclear warfare	nuclear warfare
nuclear weapon design	nuclear weapon design
nuclear weapons	nuclear weapon
nuclear weapons testing	nuclear weapon testing
nucleosynthesis	nucleosynthesis
nude beaches	nude beach
nuremberg trials	nuremberg trial
nxp semiconductors	nxp semiconductor
nyaya	nyaya
observational cosmology	observational cosmology
ocean exploration	ocean exploration
oceania	oceania
oceanography	oceanography
oceans	ocean
odin	odin
oganesson	oganesson
oil lamp	oil lamp
oil shale	oil shale
olympus corporation	olympus corporation
onium	onium
operating systems	operating system
operator theory	operator theory
ophthalmology	ophthalmology
optical coherence tomography	optical coherence tomography
optical disc authoring	optical disc authoring
optical fiber	optical fiber
optical mineralogy	optical mineralogy
optical phenomena	optical phenomenon
optical spectrum	optical spectrum
optical transport network	optical transport network
optics	optic
optimal control	optimal control
optoelectronics	optoelectronics
optometry	optometry
oral history	oral history
orbital resonance	orbital resonance
organic compounds	organic compound
organic electronics	organic electronics
origin of life	origin of life
orogeny	orogeny
orthogonal polynomials	orthogonal polynomial
oscillation	oscillation
osmium	osmium
oxygen	oxygen
ozone depletion	ozone depletion
pacific ocean	pacific ocean
packaging machinery	packaging machinery
packing problems	packing problem
palearctic ecozone	palearctic ecozone
paleoceanography	paleoceanography
paleoclimatology	paleoclimatology
paleomagnetism	paleomagnetism
palladium	palladium
palynology	palynology
pampas	pampas
panavision	panavision
parachuting	parachuting
paragliding	paragliding
parallax	parallax
parker solar probe	parker solar probe
particle physics	particle physic
particle statistics	particle statistic
particulates	particulate
passive fire protection	passive fire protection
past	past
pattern formation	pattern formation
pattern matching	pattern matching
pauli exclusion principle	pauli exclusion principle
peaceful nuclear explosions	peaceful nuclear explosion
peat	peat
peer learning	peer learning
peer review	peer review
peer support	peer support
pellucidar	pellucidar
pendulums	pendulum
percolation theory	percolation theory
periodic table	periodic table
perpetual motion	perpetual motion
perseus cluster	perseus cluster
personal computing	personal computing
perturbation theory	perturbation theory
peter debye	peter debye
peter madsen	peter madsen
petroleum	petroleum
petroleum geology	petroleum geology
petroleum industry	petroleum industry
petroleum politics	petroleum politics
petroleum products	petroleum product
phase transitions	phase transition
philosophy of history	philosophy of history
philosophy of mind	philosophy of mind
philosophy of physics	philosophy of physic
philosophy of time	philosophy of time
phospholipids	phospholipid
phosphorus	phosphorus
photochemistry	photochemistry
photographic lighting	photographic lighting
photographic processes	photographic process
photographs	photograph
photography	photography
photonics	photonics
photons	photon
photosynthesis	photosynthesis
photovoltaics	photovoltaics
physical chemistry	physical chemistry
physical computing	physical computing
physical cosmology	physical cosmology
physical oceanography	physical oceanography
physical optics	physical optic
physical organic chemistry	physical organic chemistry
phytochemicals	phytochemical
phytogeography	phytogeography
pigments	pigment
pipeline transport	pipeline transport
piping	piping
piracy	piracy
pistonless rotary engine	pistonless rotary engine
planning	planning
plasma diagnostics	plasma diagnostics
plasma physics	plasma physic
plastic welding	plastic welding
plastics	plastic
plastics industry	plastic industry
plate tectonics	plate tectonics
platinum	platinum
plesetsk cosmodrome	plesetsk cosmodrome
plumbing	plumbing
plutonium	plutonium
pneumatics	pneumatics
polonium	polonium
polymer chemistry	polymer chemistry
polymer physics	polymer physic
polymers	polymer
polynesian culture	polynesian culture
polynesian navigation	polynesian navigation
polyphenols	polyphenols
polysaccharides	polysaccharide
porcelain	porcelain
positron emission tomography	positron emission tomography
posttranslational modification	posttranslational modification
potassium	potassium
potential theory	potential theory
power control	power control
power electronics	power electronics
power engineering	power engineering
power machines	power machine
power rangers rpm	power ranger rpm
praseodymium	praseodymium
precession	precession
precious metals	precious metal
precipitation	precipitation
precursors of film	precursor of film
prediction	prediction
prevention	prevention
private spaceflight	private spaceflight
privateering	privateering
privateers	privateer
process engineering	process engineering
process safety	process safety
production planning	production planning
programming language theory	programming language theory
promethium	promethium
prophecy	prophecy
protactinium	protactinium
protein folding	protein folding
protein structure	protein structure
protein targeting	protein targeting
proteins	protein
proton	proton
proton pump inhibitors	proton pump inhibitor
pseudohistory	pseudohistory
psychoacoustics	psychoacoustics
psychophysics	psychophysics
psychrometrics	psychrometrics
pulsed power	pulsed power
pupil	pupil
qualcomm	qualcomm
quantum biology	quantum biology
quantum chemistry	quantum chemistry
quantum chromodynamics	quantum chromodynamics
quantum complexity theory	quantum complexity theory
quantum computing	quantum computing
quantum cryptography	quantum cryptography
quantum dots	quantum dot
quantum electrodynamics	quantum electrodynamics
quantum electronics	quantum electronics
quantum field theory	quantum field theory
quantum gravity	quantum gravity
quantum information science	quantum information science
quantum information theory	quantum information theory
quantum mechanics	quantum mechanic
quantum monte carlo	quantum monte carlo
quantum mysticism	quantum mysticism
quantum optics	quantum optic
quantum programming	quantum programming
quark matter	quark matter
quarks	quark
quartz	quartz
quasars	quasar
radar	radar
radiation	radiation
radiation protection	radiation protection
radiation therapy	radiation therapy
radio	radio
radio communications	radio communication
radio resource management	radio resource management
radio spectrum	radio spectrum
radioactive contamination	radioactive contamination
radioactive quackery	radioactive quackery
radioactive waste	radioactive waste
radioactivity	radioactivity
radiobiology	radiobiology
radiocarbon dating	radiocarbon dating
radiochemistry	radiochemistry
radiography	radiography
radiology	radiology
radiometric dating	radiometric dating
radiometry	radiometry
radium	radium
radon	radon
rahxephon	rahxephon
rainbow	rainbow
raman scattering	raman scattering
raman spectroscopy	raman spectroscopy
random number generation	random number generation
reboot	reboot
recreational fishing	recreational fishing
reductionism	reductionism
reforestation	reforestation
refraction	refraction
refractory metals	refractory metal
refrigerants	refrigerant
reliability engineering	reliability engineering
religion in oceania	religion in oceania
remote control	remote control
remote sensing	remote sensing
remote sensing software	remote sensing software
renormalization group	renormalization group
reprap project	reprap project
reputation management	reputation management
resonance	resonance
retro style	retro style
retrofuturism	retrofuturism
rhenium	rhenium
rheology	rheology
rhodium	rhodium
riemannian geometry	riemannian geometry
riken	riken
rip van winkle	rip van winkle
riparian zone	riparian zone
rms titanic	rms titanic
roadkill	roadkill
robot control	robot control
robot kinematics	robot kinematics
robot locomotion	robot locomotion
robotic art	robotic art
robotics	robotics
robots	robot
rock magnetism	rock magnetism
rock mechanics	rock mechanic
rocket artillery	rocket artillery
rocks	rock
roentgenium	roentgenium
rosatom	rosatom
rotation	rotation
rotational symmetry	rotational symmetry
rubidium	rubidium
rural electrification	rural electrification
ruthenium	ruthenium
rutherfordium	rutherfordium
saccade	saccade
saliva	saliva
samarium	samarium
sampling	sampling
sandisk	sandisk
santorini	santorini
satellite imagery	satellite imagery
satellite internet access	satellite internet access
satellite radio	satellite radio
satellite television	satellite television
scandium	scandium
scanning probe microscopy	scanning probe microscopy
scattering	scattering
scattering theory	scattering theory
science of photography	science of photography
scientific diving	scientific diving
scrubbers	scrubber
sea ice	sea ice
sea in culture	sea in culture
sea level	sea level
sea life centres	sea life centre
sea of okhotsk	sea of okhotsk
sea shanties	sea shanty
seaborgium	seaborgium
seafood	seafood
seagrass	seagrass
seal hunting	seal hunting
seasteading	seasteading
secretion	secretion
seismic intensity scales	seismic intensity scale
seismic magnitude scales	seismic magnitude scale
seismology	seismology
selenium	selenium
semen	semen
semiconductor device fabrication	semiconductor device fabrication
semiconductor devices	semiconductor device
semiconductors	semiconductor
sensors	sensor
sexual dimorphism	sexual dimorphism
shapley supercluster	shapley supercluster
shin megami tensei	shin megami tensei
ship collision	ship collision
ship management	ship management
ship registration	ship registration
shipbuilding	shipbuilding
ships	ship
shoe polish	shoe polish
shooting sports	shooting sport
shot peening	shot peening
sigma corporation	sigma corporation
signage	signage
signal processing	signal processing
signals intelligence	signal intelligence
silence	silence
silent film	silent film
silent hill	silent hill
silicon	silicon
silicon photonics	silicon photonics
silver	silver
simple machines	simple machine
singular value decomposition	singular value decomposition
singularitarianism	singularitarianism
singularity theory	singularity theory
sliders	slider
slot machines	slot machine
smart devices	smart device
smart tv	smart tv
smelting	smelting
smog	smog
smoke	smoke
smoking	smoking
snow	snow
social bookmarking	social bookmarking
social networks	social network
sociophysics	sociophysics
sodium	sodium
soft computing	soft computing
soft matter	soft matter
software	software
software architecture	software architecture
software design	software design
software development	software development
software distribution	software distribution
software engineering	software engineering
software industry	software industry
software maintenance	software maintenance
software quality	software quality
software requirements	software requirement
software testing	software testing
soil	soil
soil classification	soil classification
soil contamination	soil contamination
soil mechanics	soil mechanic
soil physics	soil physic
solar architecture	solar architecture
solar cells	solar cell
solar decathlon	solar decathlon
solar energy	solar energy
solar hijri calendar	solar hijri calendar
solar phenomena	solar phenomenon
solar power	solar power
solar thermal energy	solar thermal energy
solid mechanics	solid mechanic
solitons	soliton
solutions	solution
solvents	solvent
sonar	sonar
sony	sony
sound	sound
sound effects	sound effect
sound recording	sound recording
sound reinforcement system	sound reinforcement system
soundscape ecology	soundscape ecology
south pacific	south pacific
southern ocean	southern ocean
space colonization	space colonization
space debris	space debris
space elevator	space elevator
space law	space law
space physics	space physic
space policy	space policy
space transport	space transport
space weather	space weather
spacecraft	spacecraft
spacecraft propulsion	spacecraft propulsion
spaceflight	spaceflight
spaceshiptwo	spaceshiptwo
special functions	special function
special relativity	special relativity
speckle imaging	speckle imaging
spectral theory	spectral theory
spectroscopy	spectroscopy
speech processing	speech processing
speech recognition	speech recognition
spike and suzy	spike and suzy
spintronics	spintronics
sponge diving	sponge diving
stability theory	stability theory
stage lighting	stage lighting
staining	staining
standard model	standard model
star formation	star formation
star trek	star trek
star wars	star war
stargate	stargate
statics	static
statistical distance	statistical distance
statistical mechanics	statistical mechanic
statistical physics	statistical physic
statistical signal processing	statistical signal processing
steam power	steam power
steampunk	steampunk
steel	steel
steelmaking	steelmaking
stellar dynamics	stellar dynamic
stellar evolution	stellar evolution
stephen hawking	stephen hawking
stereophonic sound	stereophonic sound
stereoscopy	stereoscopy
storm	storm
storm chasing	storm chasing
strangeness production	strangeness production
strategy	strategy
string theory	string theory
strontium	strontium
strontium dog	strontium dog
structural analysis	structural analysis
structural bioinformatics	structural bioinformatics
structural biology	structural biology
subatomic particles	subatomic particle
subduction	subduction
sulfur	sulfur
sun	sun
sun tanning	sun tanning
superalloys	superalloys
superconductivity	superconductivity
superconductors	superconductors
supermassive black holes	supermassive black hole
supernovae	supernova
supersonic aircraft	supersonic aircraft
supersymmetry	supersymmetry
superzoom	superzoom
supramolecular chemistry	supramolecular chemistry
surface science	surface science
surfactants	surfactant
surveying	surveying
swamps	swamp
symbolic dynamics	symbolic dynamic
symbols	symbol
symmetry	symmetry
symplectic geometry	symplectic geometry
synchronization	synchronization
synchronous optical networking	synchronous optical networking
synchrotron radiation	synchrotron radiation
synthetic aperture radar	synthetic aperture radar
synthetic resins	synthetic resin
systems ecology	system ecology
systems science	system science
systems thinking	system thinking
tamron	tamron
tantalum	tantalum
tarantula nebula	tarantula nebula
tau ceti	tau ceti
technetium	technetium
technology assessment	technology assessment
tectonic plates	tectonic plate
tektronix	tektronix
telecommunications	telecommunication
telecommunications engineering	telecommunication engineering
telecommunications equipment	telecommunication equipment
telecommuting	telecommuting
telegraphy	telegraphy
telematics	telematics
telemetry	telemetry
telephony	telephony
teleportation	teleportation
teleportation in fiction	teleportation in fiction
telepresence	telepresence
teletext	teletext
television	television
tellurium	tellurium
temperate coniferous forests	temperate coniferous forest
temperature	temperature
temperature control	temperature control
temporal logic	temporal logic
tennessine	tennessine
tensors	tensor
terbium	terbium
terracotta	terracotta
terrestrial locomotion	terrestrial locomotion
tessellation	tessellation
thallium	thallium
the dark tower	the dark tower
the invisible man	the invisible man
the long earth	the long earth
the stand	the stand
the time machine	the time machine
the wicked years	the wicked year
theoretical computer science	theoretical computer science
theoretical physics	theoretical physic
theories of gravitation	theory of gravitation
theory of computation	theory of computation
theory of relativity	theory of relativity
thermobaric weapons	thermobaric weapon
thermochemistry	thermochemistry
thermochromism	thermochromism
thermodynamic equations	thermodynamic equation
thermodynamic free energy	thermodynamic free energy
thermodynamics	thermodynamics
thermoregulation	thermoregulation
thomas newcomen	thomas newcomen
thor	thor
thorium	thorium
thulium	thulium
tiamat	tiamat
tidal power	tidal power
tides	tide
tiktok	tiktok
time loop	time loop
time management	time management
time travel	time travel
timecop	timecop
timor sea	timor sea
tin	tin
tires	tire
titanium	titanium
tokina	tokina
tomography	tomography
topography	topography
tornado	tornado
tornadoes	tornado
tornadogenesis	tornadogenesis
torque	torque
torsional vibration	torsional vibration
tradition	tradition
traditionalist school	traditionalist school
traditions	tradition
transatlantic flight	transatlantic flight
transatlantic relations	transatlantic relation
transhumance	transhumance
transhumanism	transhumanism
transistors	transistor
transport phenomena	transport phenomenon
trauma surgery	trauma surgery
traumatology	traumatology
triangulum galaxy	triangulum galaxy
tribology	tribology
tropical andes	tropical andes
tropical cyclones	tropical cyclone
tropical rainforests	tropical rainforest
tsunami	tsunami
tsunamis	tsunami
tundra	tundra
tungsten	tungsten
tunnel construction	tunnel construction
turbomachinery	turbomachinery
turbulence	turbulence
tycho brahe	tycho brahe
types of earthquake	type of earthquake
ultrasound	ultrasound
ultraviolet radiation	ultraviolet radiation
unconventional oil	unconventional oil
uninterruptible power supply	uninterruptible power supply
units of information	unit of information
uranium	uranium
uranium mining	uranium mining
urban planning	urban planning
urine	urine
vacuum	vacuum
vacuum tubes	vacuum tube
vanadium	vanadium
variance reduction	variance reduction
vehicle dynamics	vehicle dynamic
velocity	velocity
vending machines	vending machine
ventilation	ventilation
version control	version control
vertical position	vertical position
vessel traffic service	vessel traffic service
video	video
video art	video art
video compression	video compression
video gaming	video gaming
video on demand	video on demand
video processing	video processing
video signal	video signal
video surveillance	video surveillance
videotape	videotape
videotelephony	videotelephony
virgo cluster	virgo cluster
virgo supercluster	virgo supercluster
virology	virology
viscosity	viscosity
visibility	visibility
vision	vision
visual arts	visual art
visual perception	visual perception
visual system	visual system
vitreous enamel	vitreous enamel
volcanoes	volcano
voltage	voltage
voltage regulation	voltage regulation
vomiting	vomiting
wabtec	wabtec
wafer bonding	wafer bonding
walking	walking
watches	watch
water	water
water ice	water ice
water management	water management
water power	water power
water scarcity	water scarcity
water torture	water torture
waterborne diseases	waterborne disease
wave power	wave power
waves	wave
waves in plasmas	wave in plasma
weather	weather
weather forecasting	weather forecasting
weather modification	weather modification
web archiving	web archiving
web development	web development
weightlessness	weightlessness
welding	welding
well logging	well logging
westinghouse broadcasting	westinghouse broadcasting
westinghouse electric company	westinghouse electric company
wetlands	wetland
whale conservation	whale conservation
whaling	whaling
white phosphorus	white phosphorus
white sea	white sea
wiki software	wiki software
wikileaks	wikileaks
wikimedia	wikimedia
wikimedia foundation	wikimedia foundation
wind	wind
wind power	wind power
wind turbines	wind turbine
windows	window
winter	winter
wire	wire
wireless	wireless
wireless energy transfer	wireless energy transfer
wireless networking	wireless networking
women in firefighting	woman in firefighting
wood fuel	wood fuel
wool	wool
world meteorological organization	world meteorological organization
wormholes in fiction	wormhole in fiction
writing systems	writing system
xenon	xenon
yellow sea	yellow sea
ytterbium	ytterbium
yttrium	yttrium
zambezian region	zambezian region
zealandia	zealandia
zeus	zeus
zinc	zinc
zirconium	zirconium
