abstract algebra	abstract algebra
academic ranks	academic rank
acceleration	acceleration
access control	access control
accuracy and precision	accuracy and precision
acoustics	acoustic
active fire protection	active fire protection
actuarial science	actuarial science
actuators	actuator
addition	addition
additive number theory	additive number theory
adjoint functors	adjoint functors
advanced encryption standard	advanced encryption standard
aether theories	aether theory
affective computing	affective computing
affine geometry	affine geometry
afterlife	afterlife
ageing	ageing
agricultural machinery	agricultural machinery
air quality index	air quality index
alchemical symbols	alchemical symbol
algebra	algebra
algebraic combinatorics	algebraic combinatorics
algebraic geometry	algebraic geometry
algebraic graph theory	algebraic graph theory
algebraic logic	algebraic logic
algebraic number theory	algebraic number theory
algebraic topology	algebraic topology
algorithmic art	algorithmic art
algorithmic information theory	algorithmic information theory
algorithmic trading	algorithmic trading
algorithms	algorithm
alpha centauri	alpha centauri
alphago	alphago
amalgam comics	amalgam comic
ambiguity	ambiguity
american football strategy	american football strategy
analogy	analogy
analysis of algorithms	analysis of algorithm
analytic geometry	analytic geometry
analytic number theory	analytic number theory
anatomically modern humans	anatomically modern human
andromeda galaxy	andromeda galaxy
angle	angle
animal communication	animal communication
animal crossing	animal crossing
applications of randomness	application of randomness
applied mathematics	applied mathematics
applied statistics	applied statistic
approximation theory	approximation theory
arbelos	arbelos
archimedes	archimedes
architectural lighting design	architectural lighting design
architecture description language	architecture description language
area	area
arithmetic	arithmetic
arithmetic dynamics	arithmetic dynamic
armscii	armscii
arrowverse	arrowverse
arson	arson
artificial intelligence	artificial intelligence
artificial life	artificial life
artificial neural networks	artificial neural network
ascii	ascii
assisted suicide	assisted suicide
astrology	astrology
astronomical symbols	astronomical symbol
asymmetric information	asymmetric information
asymmetrical aircraft	asymmetrical aircraft
asymmetry	asymmetry
asymptotic analysis	asymptotic analysis
atmosphere	atmosphere
atmosphere of earth	atmosphere of earth
atmospheric dispersion modeling	atmospheric dispersion modeling
atmospheric sounding	atmospheric sounding
atmospheric thermodynamics	atmospheric thermodynamics
auction chant	auction chant
auction theory	auction theory
audio electronics	audio electronics
audio mixing	audio mixing
authentication	authentication
autocad	autocad
autocorrelation	autocorrelation
automated reasoning	automated reasoning
automated teller machines	automated teller machine
automated theorem proving	automated theorem proving
automatic test equipment	automatic test equipment
automation	automation
avionics	avionics
axiom of choice	axiom of choice
axiomatic semantics	axiomatic semantics
ayya vaikundar	ayya vaikundar
bamboo network	bamboo network
baseball statistics	baseball statistic
basketball statistics	basketball statistic
bayesian inference	bayesian inference
bayesian networks	bayesian network
bayesian statistics	bayesian statistic
bcd	bcd
beam robotics	beam robotics
belief revision	belief revision
bicycle lighting	bicycle lighting
bifurcation theory	bifurcation theory
biocybernetics	biocybernetics
biodiversity	biodiversity
biofeedback	biofeedback
bioinformatics	bioinformatics
biometrics	biometrics
bionicle	bionicle
bionics	bionics
biorobotics	biorobotics
biostatistics	biostatistics
birational geometry	birational geometry
bittorrent	bittorrent
black holes	black hole
bletchley park	bletchley park
blindness	blindness
boolean algebra	boolean algebra
braille	braille
braille technology	braille technology
buffalo six	buffalo six
build automation	build automation
building automation	building automation
building information modeling	building information modeling
building insulation materials	building insulation material
business continuity	business continuity
byzantine military manuals	byzantine military manual
calculus	calculus
calculus of variations	calculus of variation
caller id	caller id
calorimetry	calorimetry
cambridge analytica	cambridge analytica
can bus	can bus
candelabra	candelabra
candles	candle
capacitance	capacitance
card games	card game
cartography	cartography
caste	caste
categorical data	categorical data
categorical logic	categorical logic
category theory	category theory
causal inference	causal inference
causality	causality
celestial coordinate system	celestial coordinate system
cell death	cell death
cellular automata	cellular automaton
center of population	center of population
central limit theorem	central limit theorem
change detection	change detection
chaos theory	chaos theory
character encoding	character encoding
cheating in chess	cheating in chess
chemical bonding	chemical bonding
chemical thermodynamics	chemical thermodynamics
cheminformatics	cheminformatics
chess	chess
chess equipment	chess equipment
chess notation	chess notation
chess strategy	chess strategy
chess tactics	chess tactic
chess theory	chess theory
chess titles	chess title
chicago seven	chicago seven
chirality	chirality
choctaw code talkers	choctaw code talker
chromatography software	chromatography software
chronology	chronology
circle of fifths	circle of fifth
circle packing	circle packing
circuit complexity	circuit complexity
clans	clan
class field theory	class field theory
classical control theory	classical control theory
classical field theory	classical field theory
classical logic	classical logic
cloud gaming	cloud gaming
cloud robotics	cloud robotics
cluster analysis	cluster analysis
cnc	cnc
coats of arms	coat of arm
code lyoko	code lyoko
coding theory	coding theory
cognitive architecture	cognitive architecture
cognitive grammar	cognitive grammar
cognitive inertia	cognitive inertia
coin flipping	coin flipping
coincidence	coincidence
cold	cold
cold fusion	cold fusion
collation	collation
color	color
color space	color space
color vision	color vision
coma cluster	coma cluster
combinatorial chemistry	combinatorial chemistry
combinatorial game theory	combinatorial game theory
combinatorial optimization	combinatorial optimization
combinatorics	combinatorics
combinatorics on words	combinatorics on word
combinatory logic	combinatory logic
communication	communication
communication design	communication design
communication studies	communication study
communication theory	communication theory
communications security establishment	communication security establishment
community	community
commutative algebra	commutative algebra
comparative statics	comparative static
competition	competition
competitive intelligence	competitive intelligence
complex analysis	complex analysis
complex dynamics	complex dynamic
complex numbers	complex number
complexity economics	complexity economics
computability theory	computability theory
computational anatomy	computational anatomy
computational biology	computational biology
computational chemistry	computational chemistry
computational complexity theory	computational complexity theory
computational economics	computational economics
computational electromagnetics	computational electromagnetics
computational fluid dynamics	computational fluid dynamic
computational geometry	computational geometry
computational learning theory	computational learning theory
computational linguistics	computational linguistics
computational mathematics	computational mathematics
computational neuroscience	computational neuroscience
computational number theory	computational number theory
computational phylogenetics	computational phylogenetics
computational physics	computational physic
computational science	computational science
computational social science	computational social science
computational statistics	computational statistic
computational topology	computational topology
computational trust	computational trust
computer access control	computer access control
computer algebra	computer algebra
computer chess	computer chess
computer forensics	computer forensics
computer go	computer go
computer security	computer security
computer security software	computer security software
computer shogi	computer shogi
computer surveillance	computer surveillance
computer vision	computer vision
concubinage	concubinage
conditional probability	conditional probability
confession	confession
conformal geometry	conformal geometry
conformity	conformity
connotation	connotation
consonance and dissonance	consonance and dissonance
constraint logic programming	constraint logic programming
constraint programming	constraint programming
constructible universe	constructible universe
construction grammar	construction grammar
contact geometry	contact geometry
contract bridge probabilities	contract bridge probability
control data corporation	control data corporation
control engineering	control engineering
control theory	control theory
convection	convection
convergence tests	convergence test
convex analysis	convex analysis
convex geometry	convex geometry
convex hull algorithms	convex hull algorithm
convex optimization	convex optimization
cooperative economics	cooperative economics
copy protection	copy protection
correspondence chess	correspondence chess
cosmic background radiation	cosmic background radiation
cosmic rays	cosmic ray
covariance and correlation	covariance and correlation
coventry transport museum	coventry transport museum
cray	cray
crime statistics	crime statistic
criminal defenses	criminal defense
critical phenomena	critical phenomenon
crowdsourcing	crowdsourcing
cryobiology	cryobiology
cryogenics	cryogenics
cryonics	cryonics
cryopreservation	cryopreservation
cryotherapy	cryotherapy
cryptocurrencies	cryptocurrencies
cryptography	cryptography
cryptography law	cryptography law
cryptography standards	cryptography standard
crystallography	crystallography
cultural assimilation	cultural assimilation
cultural heritage	cultural heritage
cybernetics	cybernetics
cyberpsychology	cyberpsychology
cyborgs in fiction	cyborg in fiction
dark matter	dark matter
dark triad	dark triad
dark web	dark web
darkness	darkness
data compression	data compression
data differencing	data differencing
data encryption standard	data encryption standard
data mining	data mining
data security	data security
dc animated universe	dc animated universe
dc extended universe	dc extended universe
death	death
deception	deception
decision theory	decision theory
deductive reasoning	deductive reasoning
deep learning	deep learning
defense	defense
defensive gun use	defensive gun use
definition	definition
demographic economics	demographic economics
demographic history	demographic history
demographics	demographic
demography	demography
demoscene	demoscene
denotational semantics	denotational semantics
density	density
density functional theory	density functional theory
descriptive geometry	descriptive geometry
descriptive set theory	descriptive set theory
descriptive statistics	descriptive statistic
desiccation	desiccation
design of experiments	design of experiment
design theory	design theory
detection theory	detection theory
determinacy	determinacy
dewey decimal classification	dewey decimal classification
diacritics	diacritic
dialectical materialism	dialectical materialism
dice	dice
difference	difference
differential algebra	differential algebra
differential calculus	differential calculus
differential equations	differential equation
differential geometry	differential geometry
differential privacy	differential privacy
differential topology	differential topology
differentiation rules	differentiation rule
diffraction	diffraction
diffusion	diffusion
digimon	digimon
digital audio	digital audio
digital cameras	digital camera
digital currencies	digital currency
digital geometry	digital geometry
digital humanities	digital humanity
digital manufacturing	digital manufacturing
digital marketing	digital marketing
digital photography	digital photography
digital rights management	digital right management
digital signal processing	digital signal processing
digital signature	digital signature
digital watermarking	digital watermarking
dimension	dimension
dimensional analysis	dimensional analysis
diophantine approximation	diophantine approximation
diophantine equations	diophantine equation
diophantine geometry	diophantine geometry
dirac equation	dirac equation
directional statistics	directional statistic
directx	directx
discrete geometry	discrete geometry
discrete mathematics	discrete mathematics
discrimination	discrimination
disk encryption	disk encryption
distance	distance
district cooling	district cooling
divergent series	divergent series
divisor function	divisor function
dnssec	dnssec
domain theory	domain theory
draughts	draught
drying	drying
dualism	dualism
dynamic programming	dynamic programming
dynamical systems	dynamical system
ear training	ear training
ebcdic code pages	ebcdic code page
ecofeminism	ecofeminism
ecological genetics	ecological genetics
economic data	economic data
economic systems	economic system
eight immortals	eight immortal
electrodynamics	electrodynamics
electromagnetic compatibility	electromagnetic compatibility
electromagnetic radiation	electromagnetic radiation
electromagnetic spectrum	electromagnetic spectrum
electronic data interchange	electronic data interchange
electronic filter topology	electronic filter topology
electronic funds transfer	electronic fund transfer
electronic test equipment	electronic test equipment
elementary algebra	elementary algebra
elementary arithmetic	elementary arithmetic
elementary mathematics	elementary mathematics
elements of music	element of music
elliptic curve cryptography	elliptic curve cryptography
elseworlds	elseworlds
email authentication	email authentication
embedded systems	embedded system
emergence	emergence
emergent gameplay	emergent gameplay
emigration	emigration
emoticons	emoticon
emv	emv
endlings	endlings
energetics	energetics
energy policy	energy policy
engineering statistics	engineering statistic
enigma machine	enigma machine
enneagram	enneagram
ensemble learning	ensemble learning
enterprise modelling	enterprise modelling
enthalpy	enthalpy
entropy	entropy
enumerative combinatorics	enumerative combinatorics
environmental communication	environmental communication
environmental statistics	environmental statistic
epidemics	epidemic
epidemiology	epidemiology
equilibrium chemistry	equilibrium chemistry
ergodic theory	ergodic theory
estimation theory	estimation theory
ethnic conflict	ethnic conflict
ethnic groups	ethnic group
ethnic pornography	ethnic pornography
ethnic religion	ethnic religion
ethnic studies	ethnic study
ethnicity	ethnicity
ethnography	ethnography
ethnology	ethnology
euclidean geometry	euclidean geometry
euthanasia	euthanasia
evolution of tetrapods	evolution of tetrapod
evolutionary algorithms	evolutionary algorithm
evolutionary computation	evolutionary computation
evolutionary game theory	evolutionary game theory
expected utility	expected utility
experimental mathematics	experimental mathematics
expert systems	expert system
explosives	explosive
extinction	extinction
extremal graph theory	extremal graph theory
face recognition	face recognition
factor analysis	factor analysis
fair division	fair division
fault tolerance	fault tolerance
federal reserve system	federal reserve system
feedback	feedback
ferdinand de saussure	ferdinand de saussure
feudalism	feudalism
fiber optics	fiber optic
fibonacci numbers	fibonacci number
fictional serial killers	fictional serial killer
field theory	field theory
film series	film series
financial risk modeling	financial risk modeling
finite differences	finite difference
finite element method	finite element method
finite geometry	finite geometry
finite model theory	finite model theory
fire	fire
fire emblem	fire emblem
fire protection	fire protection
firefighting	firefighting
firelighting	firelighting
fireworks	firework
firmware	firmware
flags	flag
flamethrowers	flamethrower
flatulence	flatulence
flow visualization	flow visualization
fluid mechanics	fluid mechanic
fog	fog
force	force
forced migration	forced migration
forensic statistics	forensic statistic
formal methods	formal method
formal specification	formal specification
fornax cluster	fornax cluster
fortran	fortran
forward proxy	forward proxy
foundations of geometry	foundation of geometry
foundations of mathematics	foundation of mathematics
four heavenly kings	four heavenly king
fourier analysis	fourier analysis
fourier series	fourier series
fractals	fractal
fractional calculus	fractional calculus
franchising	franchising
fredholm theory	fredholm theory
free statistical software	free statistical software
functional analysis	functional analysis
functional calculus	functional calculus
fusion power	fusion power
future	future
futurology	futurology
fuzzy logic	fuzzy logic
gabriel knight	gabriel knight
galaxies	galaxy
galaxies in fiction	galaxy in fiction
galois theory	galois theory
gambling mathematics	gambling mathematics
game design	game design
game theory	game theory
gamma rays	gamma ray
gang of four	gang of four
gas laws	gas law
gas separation	gas separation
gaseous signaling molecules	gaseous signaling molecule
gaussian function	gaussian function
gears of war	gear of war
gene expression programming	gene expression programming
genealogy	genealogy
general equilibrium theory	general equilibrium theory
general relativity	general relativity
general semantics	general semantics
general topology	general topology
generic programming	generic programming
genetic algorithms	genetic algorithm
genetic epidemiology	genetic epidemiology
genetic genealogy	genetic genealogy
genetic programming	genetic programming
genomics	genomics
gentrification	gentrification
geographic information systems	geographic information system
geolocation	geolocation
geomatics	geomatics
geometric algebra	geometric algebra
geometric flow	geometric flow
geometric graph theory	geometric graph theory
geometric group theory	geometric group theory
geometric series	geometric series
geometric topology	geometric topology
geometrical optics	geometrical optic
geometry	geometry
geometry of numbers	geometry of number
geometry processing	geometry processing
geosocial networking	geosocial networking
geospatial intelligence	geospatial intelligence
geostatistics	geostatistics
geriatrics	geriatrics
gerontology	gerontology
girih	girih
gis file formats	gi file format
glycomics	glycomics
gnutella	gnutella
go players	go player
golden ratio	golden ratio
google earth	google earth
government communications headquarters	government communication headquarters
gpgpu	gpgpu
grand theft auto	grand theft auto
graph coloring	graph coloring
graph drawing	graph drawing
graph operations	graph operation
graph rewriting	graph rewriting
graph theory	graph theory
gravitational lensing	gravitational lensing
gravitational waves	gravitational wave
greenhouse gases	greenhouse gas
group theory	group theory
guitar tunings	guitar tuning
hamiltonian mechanics	hamiltonian mechanic
handedness	handedness
handwriting recognition	handwriting recognition
harmonic analysis	harmonic analysis
harmony	harmony
hearthstone	hearthstone
heat conduction	heat conduction
heat exchangers	heat exchanger
heat transfer	heat transfer
heating	heating
height	height
heraldry	heraldry
hidden variable theory	hidden variable theory
hideo kojima	hideo kojima
hierarchy	hierarchy
higher category theory	higher category theory
hilbert space	hilbert space
history of algebra	history of algebra
history of calculus	history of calculus
history of chess	history of chess
history of communication	history of communication
history of cryptography	history of cryptography
history of geometry	history of geometry
history of thermodynamics	history of thermodynamics
hodge theory	hodge theory
holism	holism
holography	holography
home automation	home automation
home sign	home sign
homeostasis	homeostasis
homological algebra	homological algebra
homology theory	homology theory
homomorphic encryption	homomorphic encryption
homotopy theory	homotopy theory
horizontal coordinate system	horizontal coordinate system
horology	horology
human height	human height
human homeostasis	human homeostasis
human migration	human migration
human population planning	human population planning
human positions	human position
human settlement	human settlement
hurricane andrew	hurricane andrew
hurricane charley	hurricane charley
hurricane dean	hurricane dean
hurricane dennis	hurricane dennis
hurricane dorian	hurricane dorian
hurricane floyd	hurricane floyd
hurricane georges	hurricane george
hurricane harvey	hurricane harvey
hurricane hazel	hurricane hazel
hurricane ike	hurricane ike
hurricane irene	hurricane irene
hurricane irma	hurricane irma
hurricane isabel	hurricane isabel
hurricane ivan	hurricane ivan
hurricane jeanne	hurricane jeanne
hurricane katrina	hurricane katrina
hurricane maria	hurricane maria
hurricane matthew	hurricane matthew
hurricane rita	hurricane rita
hurricane sandy	hurricane sandy
hurricane wilma	hurricane wilma
hyperbolic geometry	hyperbolic geometry
hypercomputation	hypercomputation
hysteresis	hysteresis
ice hockey statistics	ice hockey statistic
ice trade	ice trade
ideal gas	ideal gas
identification	identification
image compression	image compression
image processing	image processing
image segmentation	image segmentation
imaging	imaging
immigration	immigration
immortality	immortality
incidence geometry	incidence geometry
incineration	incineration
income distribution	income distribution
indoor positioning system	indoor positioning system
induction heating	induction heating
inductive logic programming	inductive logic programming
industrial ecology	industrial ecology
industrial engineering	industrial engineering
industrial ethernet	industrial ethernet
industrial machinery	industrial machinery
inequality	inequality
inference	inference
information geometry	information geometry
information privacy	information privacy
information society	information society
information theory	information theory
infrared	infrared
insignia	insignia
inspector gadget	inspector gadget
integers	integer
integral calculus	integral calculus
integral geometry	integral geometry
intellectualism	intellectualism
interaction	interaction
interest rates	interest rate
interference	interference
intergalactic travel	intergalactic travel
internal migration	internal migration
international statistical institute	international statistical institute
interpolation	interpolation
interpretation	interpretation
intersection theory	intersection theory
interspecies communication	interspecies communication
intuitionism	intuitionism
invariant theory	invariant theory
inventory optimization	inventory optimization
inverse hyperbolic functions	inverse hyperbolic function
inverse trigonometric functions	inverse trigonometric function
inversive geometry	inversive geometry
invisibility	invisibility
ionizing radiation	ionizing radiation
irobot	irobot
isomorphism theorems	isomorphism theorem
it risk management	it risk management
jacobi elliptic functions	jacobi elliptic function
janggi	janggi
japanese militarism	japanese militarism
jbig	jbig
jpeg	jpeg
julian assange	julian assange
keeneland	keeneland
key management	key management
kid icarus	kid icarus
kinematics	kinematics
kleptography	kleptography
knight rider	knight rider
knot theory	knot theory
knowledge engineering	knowledge engineering
knowledge representation	knowledge representation
labeling theory	labeling theory
lake constance	lake constance
lambda calculus	lambda calculus
langlands program	langlands program
language	language
language acquisition	language acquisition
language interpretation	language interpretation
language of flowers	language of flower
language policy	language policy
languages	language
laniakea supercluster	laniakea supercluster
large deviations theory	large deviation theory
laser tag	laser tag
lasers	laser
last words	last word
lattice theory	lattice theory
laws of robotics	law of robotics
laws of thermodynamics	law of thermodynamics
lean manufacturing	lean manufacturing
least squares	least square
length	length
lexical analysis	lexical analysis
lexical semantics	lexical semantics
life expectancy	life expectancy
life extension	life extension
light	light
light art	light art
light pollution	light pollution
light therapy	light therapy
lighting	lighting
limits of computation	limit of computation
linear algebra	linear algebra
linear logic	linear logic
linear programming	linear programming
linguistics	linguistics
link analysis	link analysis
linkedin	linkedin
liquid helium	liquid helium
lists of galaxies	list of galaxy
lists of integrals	list of integral
lists of places	list of place
littlebigplanet	littlebigplanet
local group	local group
local sheet	local sheet
locksmithing	locksmithing
logic gates	logic gate
logic programming	logic programming
logical consequence	logical consequence
logistic regression	logistic regression
longevity	longevity
machine learning	machine learning
machine translation	machine translation
machine vision	machine vision
machinery	machinery
machinima	machinima
magical thinking	magical thinking
magnetic levitation	magnetic levitation
management science	management science
mancala	mancala
manifolds	manifold
map series	map series
maps	map
marginal concepts	marginal concept
market segmentation	market segmentation
marketing strategy	marketing strategy
marriage	marriage
martial arts	martial art
martial law	martial law
marvel animation	marvel animation
marvel cinematic universe	marvel cinematic universe
mass	mass
mass media	mass medium
matching	matching
mathematical analysis	mathematical analysis
mathematical chemistry	mathematical chemistry
mathematical economics	mathematical economics
mathematical finance	mathematical finance
mathematical induction	mathematical induction
mathematical logic	mathematical logic
mathematical morphology	mathematical morphology
mathematical optimization	mathematical optimization
mathematical physics	mathematical physic
mathematical psychology	mathematical psychology
mathematical software	mathematical software
max weber	max weber
maximum likelihood estimation	maximum likelihood estimation
means	mean
measure theory	measure theory
mechanism design	mechanism design
medical imaging	medical imaging
medical statistics	medical statistic
melody	melody
mental calculation	mental calculation
merchant services	merchant service
mesh generation	mesh generation
mesh networking	mesh networking
metaprogramming	metaprogramming
microblogging	microblogging
microlocal analysis	microlocal analysis
microscopy	microscopy
microwave transmission	microwave transmission
militarism	militarism
military	military
military art	military art
military law	military law
military medicine	military medicine
military organization	military organization
military personnel	military personnel
military recruitment	military recruitment
military strategy	military strategy
military tactics	military tactic
military terminology	military terminology
milky way	milky way
minkowski spacetime	minkowski spacetime
missile guidance	missile guidance
missing data	missing data
misuse of statistics	misuse of statistic
mobile security	mobile security
modal logic	modal logic
model checking	model checking
model selection	model selection
model theory	model theory
modeling and simulation	modeling and simulation
modular arithmetic	modular arithmetic
modularity	modularity
molecular dynamics	molecular dynamic
molecular geometry	molecular geometry
molecular modelling	molecular modelling
molecular vibration	molecular vibration
monadology	monadology
monism	monism
monster rancher	monster rancher
moonshine theory	moonshine theory
moral psychology	moral psychology
morse code	morse code
morse theory	morse theory
motion control	motion control
motion control photography	motion control photography
muhajir	muhajir
multilinear algebra	multilinear algebra
multiple comparisons	multiple comparison
multiplication	multiplication
multivariable calculus	multivariable calculus
multivariate cryptography	multivariate cryptography
multivariate interpolation	multivariate interpolation
multivariate statistics	multivariate statistic
musical form	musical form
musical tuning	musical tuning
mutation	mutation
narcissism	narcissism
national accounts	national account
national security agency	national security agency
natural gas	natural gas
natural language generation	natural language generation
natural language processing	natural language processing
natural units	natural unit
navajo code talkers	navajo code talker
neanderthals	neanderthal
necrophilia	necrophilia
neon lighting	neon lighting
neopets	neopets
netsukuku	netsukuku
network analysis	network analysis
network flow problem	network flow problem
network performance	network performance
network theory	network theory
network topology	network topology
neural coding	neural coding
neural network software	neural network software
neuroinformatics	neuroinformatics
neuroprosthetics	neuroprosthetics
neurostimulation	neurostimulation
neurotechnology	neurotechnology
ni no kuni	ni no kuni
niels henrik abel	niels henrik abel
night	night
nintendo network	nintendo network
nitrogen	nitrogen
no frills	no frill
noble gases	noble gas
nomads	nomad
noncommutative geometry	noncommutative geometry
nonimaging optics	nonimaging optic
nonlinear algebra	nonlinear algebra
nonlinear control	nonlinear control
nonlinear optics	nonlinear optic
nonsense	nonsense
nonverbal communication	nonverbal communication
norma cluster	norma cluster
normal distribution	normal distribution
notation	notation
nuclear fusion	nuclear fusion
nuclear strategy	nuclear strategy
nucleosynthesis	nucleosynthesis
number theory	number theory
numerical analysis	numerical analysis
numerical linear algebra	numerical linear algebra
numerology	numerology
observational study	observational study
octonions	octonions
oddworld	oddworld
official statistics	official statistic
oligarchy	oligarchy
omics	omics
online banking	online banking
onomatopoeia	onomatopoeia
opengl	opengl
openpgp	openpgp
openstreetmap	openstreetmap
operational semantics	operational semantics
operations research	operation research
operator theory	operator theory
ophthalmology	ophthalmology
optical character recognition	optical character recognition
optical coherence tomography	optical coherence tomography
optical mineralogy	optical mineralogy
optical spectrum	optical spectrum
optics	optic
optimal control	optimal control
optometry	optometry
orbital resonance	orbital resonance
order theory	order theory
orders of magnitude	order of magnitude
ordinary differential equations	ordinary differential equation
origami	origami
orthogonal polynomials	orthogonal polynomial
oscillation	oscillation
outer space	outer space
packaging machinery	packaging machinery
packing problems	packing problem
palliative care	palliative care
panel data	panel data
paraconsistent logic	paraconsistent logic
parameterized complexity	parameterized complexity
pareto efficiency	pareto efficiency
parsing	parsing
partial differential equations	partial differential equation
particle statistics	particle statistic
past	past
pattern formation	pattern formation
pattern matching	pattern matching
peer learning	peer learning
peer review	peer review
peer support	peer support
percolation theory	percolation theory
perimeter security	perimeter security
permutations	permutation
persistence	persistence
perspective projection	perspective projection
perturbation theory	perturbation theory
phase transitions	phase transition
phenomenology	phenomenology
phenomics	phenomics
philology	philology
philosophy of language	philosophy of language
philosophy of mind	philosophy of mind
philosophy of psychology	philosophy of psychology
philosophy of time	philosophy of time
phonaesthetics	phonaesthetics
photochemistry	photochemistry
photogrammetry	photogrammetry
photographic lighting	photographic lighting
photonics	photonics
photons	photon
photosynthesis	photosynthesis
phylogenetics	phylogenetics
physical computing	physical computing
physical constants	physical constant
physical optics	physical optic
pi	pi
pictograms	pictograms
planescape	planescape
playstation network	playstation network
poker probability	poker probability
poker strategy	poker strategy
polaris	polaris
polygamy	polygamy
population	population
population density	population density
population ecology	population ecology
population ethics	population ethic
population genetics	population genetics
population statistics	population statistic
position	position
posture	posture
potential theory	potential theory
power control	power control
pragmatics	pragmatic
prague linguistic circle	prague linguistic circle
precession	precession
predicate logic	predicate logic
prime numbers	prime number
prison food	prison food
prison healthcare	prison healthcare
probability	probability
probability and statistics	probability and statistic
probability distribution fitting	probability distribution fitting
probability distributions	probability distribution
probability interpretations	probability interpretation
probability theory	probability theory
procedural generation	procedural generation
process mining	process mining
production planning	production planning
program analysis	program analysis
programming languages	programming language
programming paradigms	programming paradigm
projective geometry	projective geometry
proof theory	proof theory
propaganda	propaganda
propositional calculus	propositional calculus
prospect theory	prospect theory
proteomics	proteomics
psephology	psephology
pseudorandomness	pseudorandomness
psychoacoustics	psychoacoustics
psychopathy	psychopathy
psychrometrics	psychrometrics
public key infrastructure	public key infrastructure
pupil	pupil
pyramids	pyramid
pythagorean theorem	pythagorean theorem
quadratic residue	quadratic residue
quality management	quality management
quality of service	quality of service
quantitative marketing research	quantitative marketing research
quantity	quantity
quantum complexity theory	quantum complexity theory
quantum computing	quantum computing
quantum cryptography	quantum cryptography
quantum electrodynamics	quantum electrodynamics
quantum information science	quantum information science
quantum information theory	quantum information theory
quantum monte carlo	quantum monte carlo
quantum optics	quantum optic
quantum programming	quantum programming
quasars	quasar
quaternions	quaternion
quest for glory	quest for glory
queueing theory	queueing theory
race and health	race and health
radiation	radiation
radio control	radio control
radio direction finding	radio direction finding
radio spectrum	radio spectrum
radiometry	radiometry
rail transport	rail transport
ramsey theory	ramsey theory
random number generation	random number generation
randomness	randomness
ransomware	ransomware
rate of evolution	rate of evolution
rational numbers	rational number
ravenloft	ravenloft
real analysis	real analysis
real closed field	real closed field
real numbers	real number
reconnaissance	reconnaissance
reconnaissance aircraft	reconnaissance aircraft
recreational mathematics	recreational mathematics
recursion	recursion
reductionism	reductionism
refractory metals	refractory metal
refrigerants	refrigerant
regular expressions	regular expression
regular polyhedra	regular polyhedron
reinforcement learning	reinforcement learning
relational algebra	relational algebra
renju	renju
renormalization group	renormalization group
reprap project	reprap project
representation theory	representation theory
reputation management	reputation management
resonance	resonance
resource description framework	resource description framework
reverse proxy	reverse proxy
reversi	reversi
reversible computing	reversible computing
riemannian geometry	riemannian geometry
ring theory	ring theory
riverbank laboratories	riverbank laboratory
robot control	robot control
robot kinematics	robot kinematics
robotics	robotics
robots	robot
robust statistics	robust statistic
rotation	rotation
rotational symmetry	rotational symmetry
rsa factoring challenge	rsa factoring challenge
rss	r
saccade	saccade
sacred geometry	sacred geometry
saints row	saint row
school colors	school color
science adventure	science adventure
science of photography	science of photography
scientific visualization	scientific visualization
second viennese school	second viennese school
secret sharing	secret sharing
secure communication	secure communication
secure shell	secure shell
security	security
security engineering	security engineering
security software	security software
seismic intensity scales	seismic intensity scale
selection	selection
semantic web	semantic web
semantics	semantics
semiotics	semiotics
senescence	senescence
sensitivity analysis	sensitivity analysis
sensors	sensor
serial killers	serial killer
serialism	serialism
series	series
set theory	set theory
seven military classics	seven military classic
several complex variables	several complex variable
sex selection	sex selection
sexual dimorphism	sexual dimorphism
shading	shading
shapley supercluster	shapley supercluster
shenmue	shenmue
shogi	shogi
sieve theory	sieve theory
sign language	sign language
signage	signage
signal processing	signal processing
signature	signature
simplicial homology	simplicial homology
simulation	simulation
simulation software	simulation software
singular value decomposition	singular value decomposition
singularitarianism	singularitarianism
singularity theory	singularity theory
size	size
slow motion	slow motion
smart cards	smart card
smart devices	smart device
smog	smog
smoke	smoke
soap operas	soap opera
social bookmarking	social bookmarking
social dynamics	social dynamic
social inequality	social inequality
social media	social medium
social networks	social network
social statistics	social statistic
sociology of language	sociology of language
sodium	sodium
software distribution	software distribution
soil classification	soil classification
sound	sound
space	space
space quest	space quest
spacetime	spacetime
spanning tree	spanning tree
sparql	sparql
speaker recognition	speaker recognition
special functions	special function
special relativity	special relativity
spectral theory	spectral theory
spectroscopy	spectroscopy
speech processing	speech processing
speech recognition	speech recognition
speech synthesis	speech synthesis
spherical geometry	spherical geometry
spherical trigonometry	spherical trigonometry
squaring the circle	squaring the circle
stability theory	stability theory
stage lighting	stage lighting
static program analysis	static program analysis
statistical analysis	statistical analysis
statistical classification	statistical classification
statistical distance	statistical distance
statistical genetics	statistical genetics
statistical hypothesis testing	statistical hypothesis testing
statistical inference	statistical inference
statistical mechanics	statistical mechanic
statistical physics	statistical physic
statistical process control	statistical process control
statistical randomness	statistical randomness
statistical theory	statistical theory
statistics	statistic
statistics education	statistic education
steganography	steganography
stern pinball arcade	stern pinball arcade
stochastic control	stochastic control
stochastic optimization	stochastic optimization
stochastic processes	stochastic process
stochastic simulation	stochastic simulation
stoichiometry	stoichiometry
storage wars	storage war
storm	storm
strategic bombing	strategic bombing
strategic management	strategic management
strategic studies	strategic study
strategy	strategy
stress	stress
structural analysis	structural analysis
structural bioinformatics	structural bioinformatics
structural functionalism	structural functionalism
structuralism	structuralism
structured english	structured english
structured prediction	structured prediction
student migration	student migration
substructural logic	substructural logic
subtraction	subtraction
sudoku	sudoku
sun	sun
sun tzu	sun tzu
super mario maker	super mario maker
supercomputer operating systems	supercomputer operating system
supercomputers	supercomputer
supercomputing in china	supercomputing in china
supercomputing in europe	supercomputing in europe
supercomputing in india	supercomputing in india
supercomputing in japan	supercomputing in japan
supercomputing in pakistan	supercomputing in pakistan
superconductivity	superconductivity
supermassive black holes	supermassive black hole
supersymmetry	supersymmetry
supervised learning	supervised learning
support vector machines	support vector machine
surgery theory	surgery theory
survival analysis	survival analysis
sustainable business	sustainable business
symbolic dynamics	symbolic dynamic
symbolic interactionism	symbolic interactionism
symbolism	symbolism
symbols	symbol
symmetry	symmetry
symplectic geometry	symplectic geometry
synchronization	synchronization
synchrotron radiation	synchrotron radiation
synthetic biology	synthetic biology
systemic functional linguistics	systemic functional linguistics
systems biology	system biology
systems ecology	system ecology
systems engineering	system engineering
systems psychology	system psychology
systems science	system science
systems theory	system theory
systems thinking	system thinking
tamagotchi	tamagotchi
teaching	teaching
technical drawing	technical drawing
technical drawing tools	technical drawing tool
technology assessment	technology assessment
technology strategy	technology strategy
teleology	teleology
teleportation	teleportation
television series	television series
temperature	temperature
temperature control	temperature control
temporal logic	temporal logic
tensors	tensor
terminology	terminology
tessellation	tessellation
tetrapods	tetrapod
text encoding initiative	text encoding initiative
texture compression	texture compression
texture filtering	texture filtering
texture mapping	texture mapping
the culture	the culture
the elder scrolls	the elder scroll
the pinball arcade	the pinball arcade
the settlers	the settler
theoretical computer science	theoretical computer science
theoretical ecology	theoretical ecology
theory of computation	theory of computation
theory of constraints	theory of constraint
theory of mind	theory of mind
theory of relativity	theory of relativity
theosophy	theosophy
thermochemistry	thermochemistry
thermodynamic equations	thermodynamic equation
thermodynamic free energy	thermodynamic free energy
thermodynamics	thermodynamics
thermoregulation	thermoregulation
tiktok	tiktok
timbre	timbre
time	time
time management	time management
time series	time series
time travel	time travel
time zones	time zone
topography	topography
topological graph theory	topological graph theory
topology	topology
toponymy	toponymy
topos theory	topos theory
tornado	tornado
tornadoes	tornado
tornadogenesis	tornadogenesis
torsional vibration	torsional vibration
tracking	tracking
trademarks	trademark
traffic management	traffic management
transport layer security	transport layer security
transport phenomena	transport phenomenon
transportation engineering	transportation engineering
travelling salesman problem	travelling salesman problem
tres fronteras	tres fronteras
triangulum galaxy	triangulum galaxy
tribes	tribe
trigonometric functions	trigonometric function
trigonometry	trigonometry
triple deities	triple deity
tropical cyclones	tropical cyclone
tropical geometry	tropical geometry
tropical storm allison	tropical storm allison
tsunami	tsunami
turing machine	turing machine
type inference	type inference
type theory	type theory
typhoon haiyan	typhoon haiyan
uberisation	uberisation
ultimate marvel	ultimate marvel
ultraviolet radiation	ultraviolet radiation
uncrewed spacecraft	uncrewed spacecraft
undead	undead
undeciphered writing systems	undeciphered writing system
unicode	unicode
units of information	unit of information
universal algebra	universal algebra
unmanned aerial vehicles	unmanned aerial vehicle
unsupervised learning	unsupervised learning
upsilon andromedae	upsilon andromedae
urbanization	urbanization
vacuum	vacuum
value proposition	value proposition
variance reduction	variance reduction
vector calculus	vector calculus
velocity	velocity
venona project	venona project
ventilation	ventilation
vertical position	vertical position
vestibular system	vestibular system
vestibulocochlear nerve	vestibulocochlear nerve
vexillology	vexillology
video compression	video compression
video game design	video game design
video game genres	video game genre
video game graphics	video game graphic
video processing	video processing
virgo cluster	virgo cluster
virgo supercluster	virgo supercluster
vision	vision
visual arts	visual art
visual perception	visual perception
visual system	visual system
vital statistics	vital statistic
vocabulary	vocabulary
voltage	voltage
voltage regulation	voltage regulation
volume	volume
wan optimization	wan optimization
war	war
waves	wave
waves in plasmas	wave in plasma
web mapping	web mapping
web ontology language	web ontology language
web series	web series
west memphis three	west memphis three
wiki software	wiki software
wikileaks	wikileaks
wikimedia	wikimedia
wikimedia foundation	wikimedia foundation
word order	word order
world population	world population
writing	writing
writing systems	writing system
xbox live	xbox live
xiangqi	xiangqi
z notation	z notation
zero escape	zero escape
zoomusicology	zoomusicology
zoosemiotics	zoosemiotics
